各专业招生老师联系方式	__label__各专业招生老师联系方式
有各专业负责老师的电话吗	__label__各专业招生老师联系方式
有负责每个专业的老师的电话吗	__label__各专业招生老师联系方式
有没有专业老师的联系方式	__label__各专业招生老师联系方式
能给一下各专业老师的联系方式吗	__label__各专业招生老师联系方式
有负责计算机专业的老师的联系方式吗	__label__各专业招生老师联系方式
有机械专业的老师的电话吗	__label__各专业招生老师联系方式
材料专业的老师的电话多少	__label__各专业招生老师联系方式
我想联系一下电信的老师，有负责老师的电话吗	__label__各专业招生老师联系方式
能给一个土木老师的联系方式吗	__label__各专业招生老师联系方式
我想再了解一下经济类方面的具体内容，有老师的联系方式吗	__label__各专业招生老师联系方式
自动化老师的电话多少，我想打电话跟他聊一聊	__label__各专业招生老师联系方式
负责环境专业招生的老师是谁，有联系方式吗	__label__各专业招生老师联系方式
有负责电气的招生老师吗	__label__各专业招生老师联系方式
怎样能联系一下建筑老师	__label__各专业招生老师联系方式
有没有老师回答一下	__label__各专业招生老师联系方式
负责招生这块的老师是谁	__label__各专业招生老师联系方式
管招生的老师都有谁	__label__各专业招生老师联系方式
我能咨询老师吗	__label__各专业招生老师联系方式
有负责新专业的老师的联系方式吗	__label__各专业招生老师联系方式
填报方式	__label__填报方式
哈工大有三个校区，报志愿应该怎么报	__label__填报方式
志愿应该如何填报	__label__填报方式
怎么填志愿才能上哈深	__label__填报方式
要上哈深的话志愿应该怎么填	__label__填报方式
怎么样填报志愿才能上深圳校区	__label__填报方式
深圳校区的招生代码是多少，和本部是一个吗	__label__填报方式
我可以只报深圳校区的志愿吗	__label__填报方式
三个校区共用一个招生代码还是分号招生	__label__填报方式
你们不是一个分校区吗，可以只报深圳的专业吗	__label__填报方式
专业调剂是三个校区统一调剂吗	__label__填报方式
我孩子考了XX分，可以保证上深圳校区的专业吗	__label__填报方式
报志愿的时候如果填了服从，会不会被调剂到本部和威海去啊	__label__填报方式
毕业证书	__label__毕业证书
三个校区毕业证书一样吗	__label__毕业证书
毕业证书上有深圳字样吗	__label__毕业证书
毕业证跟本部有区别吗	__label__毕业证书
分校区的毕业证和本部是一样的吗	__label__毕业证书
毕业证有本部校长的章吗	__label__毕业证书
录取原则	__label__录取原则
专业录取按什么原则	__label__录取原则
有专业极差吗	__label__录取原则
投档之后保证不退档吗	__label__录取原则
分数相同时看小分的顺序是什么	__label__录取原则
如果两个人高考分一样，接下来再依据什么排名	__label__录取原则
加分政策	__label__加分政策
对政策加分有什么限制和要求吗	__label__加分政策
学校认可XX加分吗	__label__加分政策
我孩子有好几项加分，学校会全考虑吗	__label__加分政策
对军人家属的加分政策是什么	__label__加分政策
语种要求	__label__语种要求
对外语语种什么要求	__label__语种要求
外语语种只能是英语吗	__label__语种要求
外语语种除了英语还有别的吗	__label__语种要求
有外语授课的课程吗，只有英语的吧	__label__语种要求
体检要求	__label__体检要求
哈工深的材料专业对色弱有限制吗	__label__体检要求
对色弱有什么限制吗	__label__体检要求
色弱不能报哪些专业啊	__label__体检要求
对体检有额外要求吗	__label__体检要求
对体检结果有更高要求吗	__label__体检要求
我孩子视力不好，会影响专业选择吗	__label__体检要求
有点色弱，有什么专业报不了吗	__label__体检要求
本科学制	__label__本科学制
本科学制是多少	__label__本科学制
本科学制都是四年制吗	__label__本科学制
学费	__label__ 学费
本科生的学费是多少	__label__ 学费
一年收多少学费	__label__ 学费
一年的学费多少	__label__ 学费
学费高吗	__label__ 学费
一年学费多少钱	__label__ 学费
学费和本部是一样的吗	__label__ 学费
学费按学年算还是按学期算啊	__label__ 学费
江苏省考生	__label__江苏省考生
江苏省考生选测科目要求什么等级	__label__江苏省考生
我是江苏省考生，学校对选测科目的等级最低要求是多少	__label__江苏省考生
浙江省考生	__label__浙江省考生
各专业对浙江省考生选考科目有什么要求	__label__浙江省考生
选考科目因专业而异吗	__label__浙江省考生
我是浙江的，想问选考是要求必选物理吗	__label__浙江省考生
我想报XX专业，是不是就一定要选物理啊	__label__浙江省考生
浙江选科这一块要求是什么	__label__浙江省考生
转专业政策	__label__转专业政策
转专业相关的政策是什么	__label__转专业政策
怎么攻读辅修学士学位	__label__转专业政策
可以修双学士学位吗	__label__转专业政策
“辅修专业”提交申请是在哪个年级可以申请	__label__转专业政策
我是XX分，够得上XX专业吗如果不够，我能不能先上个分低的专业，到时候再转啊	__label__转专业政策
保研	__label__保研
保研率是多少	__label__保研
保研条件是什么	__label__保研
怎样才能有保研资格呢	__label__保研
保研标准是什么	__label__保研
对保研要求高吗	__label__保研
每年能有多少人保研	__label__保研
哈深16届的保研率	__label__保研
哈深16级的保研率	__label__保研
哈深16级本科生的保研率	__label__保研
哈深的保研率是百分之多少啊	__label__保研
保研率高吗	__label__保研
跟其他学校相比，保研率怎么样	__label__保研
人才培养特色	__label__人才培养特色
人才培养特色是什么	__label__人才培养特色
哈深培养什么样的人才	__label__人才培养特色
学生的培养方面有什么特点	__label__人才培养特色
安排英语授课的课程多吗	__label__人才培养特色
除了英语课之外，还会有使用英语授课的其它课程吗	__label__人才培养特色
就业前景	__label__就业前景
本校区和深圳校区相同专业，就业方向有什么不同	__label__就业前景
计算机就业前景	__label__就业前景
计算机的毕业了好找工作吗	__label__就业前景
计算机毕业生工作前景	__label__就业前景
计算机就业前景怎么样	__label__就业前景
机械就业前景	__label__就业前景
机械的毕业了好找工作吗	__label__就业前景
机械毕业生工作前景	__label__就业前景
机械就业前景怎么样	__label__就业前景
材料就业前景	__label__就业前景
材料的毕业了好找工作吗	__label__就业前景
材料毕业生工作前景	__label__就业前景
材料就业前景怎么样	__label__就业前景
电信就业前景	__label__就业前景
电信的毕业了好找工作吗	__label__就业前景
电信毕业生工作前景	__label__就业前景
电信就业前景怎么样	__label__就业前景
土木就业前景	__label__就业前景
土木的毕业了好找工作吗	__label__就业前景
土木毕业生工作前景	__label__就业前景
土木就业前景怎么样	__label__就业前景
经济就业前景	__label__就业前景
经济的毕业了好找工作吗	__label__就业前景
经济毕业生工作前景	__label__就业前景
经济就业前景怎么样	__label__就业前景
自动化就业前景	__label__就业前景
自动化的毕业了好找工作吗	__label__就业前景
自动化毕业生工作前景	__label__就业前景
自动化就业前景怎么样	__label__就业前景
环境就业前景	__label__就业前景
环境的毕业了好找工作吗	__label__就业前景
环境毕业生工作前景	__label__就业前景
环境就业前景怎么样	__label__就业前景
电气就业前景	__label__就业前景
电气的毕业了好找工作吗	__label__就业前景
电气毕业生工作前景	__label__就业前景
电气就业前景怎么样	__label__就业前景
建筑就业前景	__label__就业前景
建筑的毕业了好找工作吗	__label__就业前景
建筑毕业生工作前景	__label__就业前景
建筑就业前景怎么样	__label__就业前景
数学就业前景	__label__就业前景
数学的毕业了好找工作吗	__label__就业前景
数学毕业生工作前景	__label__就业前景
数学就业前景怎么样	__label__就业前景
工商管理就业前景	__label__就业前景
工商管理的毕业了好找工作吗	__label__就业前景
工商管理毕业生工作前景	__label__就业前景
工商管理就业前景怎么样	__label__就业前景
毕业生就业前景怎么样	__label__就业前景
毕业前景如何	__label__就业前景
毕业以后留在深圳的学生多吗	__label__就业前景
毕业生方向有哪些	__label__就业前景
就业率是多少	__label__就业前景
学生就业情况如何 	__label__就业前景
学生毕业之后好就业吗	__label__就业前景
毕业了好找工作吗	__label__就业前景
实习机会多吗	__label__就业前景
你们学校和知名企业有合作吗	__label__就业前景
有什么大企业合作项目吗	__label__就业前景
收入怎么样	__label__就业前景
住宿	__label__住宿
住宿费多少	__label__住宿
一年住宿费多少钱	__label__住宿
哈工大住宿怎么样	__label__住宿
住校多少钱	__label__住宿
住宿怎么样	__label__住宿
住校费用多少	__label__住宿
宿舍几人间	__label__住宿
有独立卫生间吗	__label__住宿
住宿条件怎么样	__label__住宿
有宿舍的照片吗	__label__住宿
宿舍条件怎么样	__label__住宿
住的地方好吗	__label__住宿
学生公寓条件如何	__label__住宿
住得怎么样	__label__住宿
住得好吗	__label__住宿
有独立卫浴吗	__label__住宿
清华北大	__label__清华北大
处在大学城，会跟北大清华研究生院有交流吗	__label__%img2%(1) 4 清华北大
会与同在大学城的清华北大有交流吗	__label__%img2%(1) 4 清华北大
哈工大可以使用清华北大的资源吗	__label__%img2%(1) 4 清华北大
能去清北听课吗	__label__%img2%(1) 4 清华北大
会和清华北大的一起上课吗	__label__%img2%(1) 4 清华北大
和清北有合作吗	__label__%img2%(1) 4 清华北大
和清华北大有学术交流吗	__label__%img2%(1) 4 清华北大
图书馆	__label__图书馆
图书馆怎么样	__label__图书馆
图书馆大不大	__label__图书馆
学校有图书馆吗	__label__图书馆
体育场	__label__体育场
学校有哪些体育设施	__label__体育场
体育设施怎么样	__label__体育场
我孩子有地方打篮球吗	__label__体育场
有地方踢足球吗	__label__体育场
有地方打排球吗	__label__体育场
有游泳馆吗	__label__体育场
有地方健身吗	__label__体育场
交通	__label__交通
学校交通便利吗	__label__交通
乘车方便吗	__label__交通
我在深圳北站怎么去学校呢	__label__交通
怎么去学校方便啊	__label__交通
哪些专业强	__label__哪些专业强
都什么专业是A+学科	__label__哪些专业强
哪些学科和专业实力强	__label__哪些专业强
有哪些比较厉害的专业与学科? 	__label__哪些专业强
哈深的特色专业是什么	__label__哪些专业强
上哈深应该选择哪个校区	__label__哪些专业强
什么专业最好啊	__label__哪些专业强
男女比例  	__label__男女比例
在校本科生男女比例 ?  	__label__男女比例
男女比例是多少 	__label__男女比例
在校本科生男女比例 ?  	__label__男女比例
学校是不是男生特别多 	__label__男女比例
在校本科生男女比例 ?  	__label__男女比例
学校补助 	__label__学校补助
学校设有哪些奖助学金 	__label__学校补助
学校有什么补助吗 	__label__学校补助
学校会有补助吗 	__label__学校补助
家里比较贫困，学校会给补助吗 	__label__学校补助
出国交流	__label__ 出国交流
学生出国、出境学习的机会多吗?	__label__ 出国交流
学校与外国大学交流机会多吗	__label__ 出国交流
学生有机会出国交流吗	__label__ 出国交流
我家孩子想出国留学，学校会给什么方便吗	__label__ 出国交流
学校给提供交流交换的机会吗	__label__ 出国交流
学校支不支持出国交流	__label__ 出国交流
本科期间的出国交流项目学校会给补助吗	__label__ 出国交流
食堂	__label__食堂
有什么菜品	__label__食堂
食堂怎么样	__label__食堂
大学食堂有几个	__label__食堂
食堂伙食怎么样	__label__食堂
总分数线	__label__总分数线
投档线多少	__label__总分数线
提档线多少	__label__总分数线
有提档线吗	__label__总分数线
有投档线吗	__label__总分数线
河北投档线多少	__label__总分数线
有河北投档线吗	__label__总分数线
河北投档线多少	__label__总分数线
有河北投档线吗	__label__总分数线
吉林投档线多少	__label__总分数线
有吉林投档线吗	__label__总分数线
吉林投档线多少	__label__总分数线
有吉林投档线吗	__label__总分数线
黑龙江投档线多少	__label__总分数线
有黑龙江投档线吗	__label__总分数线
黑龙江投档线多少	__label__总分数线
有黑龙江投档线吗	__label__总分数线
江苏投档线多少	__label__总分数线
有江苏投档线吗	__label__总分数线
江苏投档线多少	__label__总分数线
有江苏投档线吗	__label__总分数线
辽宁投档线多少	__label__总分数线
有辽宁投档线吗	__label__总分数线
辽宁投档线多少	__label__总分数线
有辽宁投档线吗	__label__总分数线
浙江投档线多少	__label__总分数线
有浙江投档线吗	__label__总分数线
浙江投档线多少	__label__总分数线
有浙江投档线吗	__label__总分数线
贵州投档线多少	__label__总分数线
有贵州投档线吗	__label__总分数线
贵州投档线多少	__label__总分数线
有贵州投档线吗	__label__总分数线
云南投档线多少	__label__总分数线
有云南投档线吗	__label__总分数线
云南投档线多少	__label__总分数线
有云南投档线吗	__label__总分数线
安徽投档线多少	__label__总分数线
有安徽投档线吗	__label__总分数线
安徽投档线多少	__label__总分数线
有安徽投档线吗	__label__总分数线
福建投档线多少	__label__总分数线
有福建投档线吗	__label__总分数线
福建投档线多少	__label__总分数线
有福建投档线吗	__label__总分数线
江西投档线多少	__label__总分数线
有江西投档线吗	__label__总分数线
江西投档线多少	__label__总分数线
有江西投档线吗	__label__总分数线
四川投档线多少	__label__总分数线
有四川投档线吗	__label__总分数线
四川投档线多少	__label__总分数线
有四川投档线吗	__label__总分数线
河南投档线多少	__label__总分数线
有河南投档线吗	__label__总分数线
河南投档线多少	__label__总分数线
有河南投档线吗	__label__总分数线
广西投档线多少	__label__总分数线
有广西投档线吗	__label__总分数线
广西投档线多少	__label__总分数线
有广西投档线吗	__label__总分数线
海南投档线多少	__label__总分数线
有海南投档线吗	__label__总分数线
海南投档线多少	__label__总分数线
有海南投档线吗	__label__总分数线
重庆投档线多少	__label__总分数线
有重庆投档线吗	__label__总分数线
重庆投档线多少	__label__总分数线
有重庆投档线吗	__label__总分数线
湖北投档线多少	__label__总分数线
有湖北投档线吗	__label__总分数线
湖北投档线多少	__label__总分数线
有湖北投档线吗	__label__总分数线
湖南投档线多少	__label__总分数线
有湖南投档线吗	__label__总分数线
湖南投档线多少	__label__总分数线
有湖南投档线吗	__label__总分数线
宁夏投档线多少	__label__总分数线
有宁夏投档线吗	__label__总分数线
宁夏投档线多少	__label__总分数线
有宁夏投档线吗	__label__总分数线
广东投档线多少	__label__总分数线
有广东投档线吗	__label__总分数线
广东投档线多少	__label__总分数线
有广东投档线吗	__label__总分数线
我家儿子考了分，能上这所大学吗	__label__总分数线
我家女儿考了分，能上这所大学吗	__label__总分数线
大概多少分能报上啊	__label__总分数线
高考分630有希望报上吗	__label__总分数线
广东专业分数线	__label__广东专业分数线
广东的录取线	__label__广东专业分数线
广东这三年每个专业的分数线是多少	__label__广东专业分数线
有广东省每个专业具体的分数线吗	__label__广东专业分数线
能知道广东省三年来每个专业的最低录取分数吗	__label__广东专业分数线
广东专业详细分数线多少	__label__广东专业分数线
有广东三年的分数线吗，最好知道每个专业的录取分	__label__广东专业分数线
有广东本省的分数线吗，具体到各专业的那种	__label__广东专业分数线
请问去年广东各专业的录取分大概多少，谁高谁低啊	__label__广东专业分数线
请问去年广东各专业的录取分大概多少，哪些专业比较高啊	__label__广东专业分数线
能提供一下广东这三年的分数线吗	__label__广东专业分数线
我想了解广东的录取分数线? 	__label__广东专业分数线
2018年广东各专业录取分数线 	__label__广东专业分数线
有广东16,17,18年的分数线吗分专业的 	__label__广东专业分数线
广东的分数线怎么样，各专业录取分数大概多少 	__label__广东专业分数线
安徽录取分数线	__label__安徽专业分数线
安徽的录取线	__label__安徽专业分数线
安徽这三年每个专业的分数线是多少	__label__安徽专业分数线
有安徽省每个专业具体的分数线吗	__label__安徽专业分数线
能知道安徽省三年来每个专业的最低录取分数吗	__label__安徽专业分数线
安徽专业详细分数线多少	__label__安徽专业分数线
有安徽三年的分数线吗，最好知道每个专业的录取分	__label__安徽专业分数线
有安徽本省的分数线吗，具体到各专业的那种	__label__安徽专业分数线
请问去年安徽各专业的录取分大概多少，谁高谁低啊	__label__安徽专业分数线
请问去年安徽各专业的录取分大概多少，哪些专业比较高啊	__label__安徽专业分数线
能提供一下安徽这三年的分数线吗	__label__安徽专业分数线
我想了解安徽的分数线	__label__安徽专业分数线
2018年安徽各专业录取分数线	__label__安徽专业分数线
有安徽16,17,18年的分数线吗分专业的	__label__安徽专业分数线
安徽的分数线怎么样，各专业录取分数大概多少	__label__安徽专业分数线
福建专业分数线	__label__福建专业分数线
福建的录取线	__label__福建专业分数线
福建这三年每个专业的分数线是多少	__label__福建专业分数线
有福建省每个专业具体的分数线吗	__label__福建专业分数线
能知道福建省三年来每个专业的最低录取分数吗	__label__福建专业分数线
福建专业详细分数线多少	__label__福建专业分数线
有福建三年的分数线吗，最好知道每个专业的录取分	__label__福建专业分数线
有福建本省的分数线吗，具体到各专业的那种	__label__福建专业分数线
请问去年福建各专业的录取分大概多少，谁高谁低啊	__label__福建专业分数线
请问去年福建各专业的录取分大概多少，哪些专业比较高啊	__label__福建专业分数线
能提供一下福建这三年的分数线吗	__label__福建专业分数线
我想了解福建的分数线	__label__福建专业分数线
2018年福建各专业录取分数线	__label__福建专业分数线
有福建16,17,18年的分数线吗分专业的	__label__福建专业分数线
福建的分数线怎么样，各专业录取分数大概多少	__label__福建专业分数线
广西专业分数线	__label__广西专业分数线
广西的录取线	__label__广西专业分数线
广西这三年每个专业的分数线是多少	__label__广西专业分数线
有广西省每个专业具体的分数线吗	__label__广西专业分数线
能知道广西省三年来每个专业的最低录取分数吗	__label__广西专业分数线
广西专业详细分数线多少	__label__广西专业分数线
有广西三年的分数线吗，最好知道每个专业的录取分	__label__广西专业分数线
有广西本省的分数线吗，具体到各专业的那种	__label__广西专业分数线
请问去年广西各专业的录取分大概多少，谁高谁低啊	__label__广西专业分数线
请问去年广西各专业的录取分大概多少，哪些专业比较高啊	__label__广西专业分数线
能提供一下广西这三年的分数线吗	__label__广西专业分数线
我想了解广西的分数线	__label__广西专业分数线
2018年广西各专业录取分数线	__label__广西专业分数线
有广西16,17,18年的分数线吗分专业的	__label__广西专业分数线
广西的分数线怎么样，各专业录取分数大概多少	__label__广西专业分数线
贵州专业分数线	__label__贵州专业分数线
贵州的录取线	__label__贵州专业分数线
贵州这三年每个专业的分数线是多少	__label__贵州专业分数线
有贵州省每个专业具体的分数线吗	__label__贵州专业分数线
能知道贵州省三年来每个专业的最低录取分数吗	__label__贵州专业分数线
贵州专业详细分数线多少	__label__贵州专业分数线
有贵州三年的分数线吗，最好知道每个专业的录取分	__label__贵州专业分数线
有贵州本省的分数线吗，具体到各专业的那种	__label__贵州专业分数线
请问去年贵州各专业的录取分大概多少，谁高谁低啊	__label__贵州专业分数线
请问去年贵州各专业的录取分大概多少，哪些专业比较高啊	__label__贵州专业分数线
能提供一下贵州这三年的分数线吗	__label__贵州专业分数线
我想了解贵州的分数线	__label__贵州专业分数线
2018年贵州各专业录取分数线	__label__贵州专业分数线
有贵州16,17,18年的分数线吗分专业的	__label__贵州专业分数线
贵州的分数线怎么样，各专业录取分数大概多少	__label__贵州专业分数线
海南专业分数线	__label__海南专业分数线
海南的录取线	__label__海南专业分数线
海南这三年每个专业的分数线是多少	__label__海南专业分数线
有海南省每个专业具体的分数线吗	__label__海南专业分数线
能知道海南省三年来每个专业的最低录取分数吗	__label__海南专业分数线
海南专业详细分数线多少	__label__海南专业分数线
有海南三年的分数线吗，最好知道每个专业的录取分	__label__海南专业分数线
有海南本省的分数线吗，具体到各专业的那种	__label__海南专业分数线
请问去年海南各专业的录取分大概多少，谁高谁低啊	__label__海南专业分数线
请问去年海南各专业的录取分大概多少，哪些专业比较高啊	__label__海南专业分数线
能提供一下海南这三年的分数线吗	__label__海南专业分数线
我想了解海南的分数线	__label__海南专业分数线
2018年海南各专业录取分数线	__label__海南专业分数线
有海南16,17,18年的分数线吗分专业的	__label__海南专业分数线
海南的分数线怎么样，各专业录取分数大概多少	__label__海南专业分数线
河北专业分数线	__label__河北专业分数线
河北的录取线	__label__河北专业分数线
河北这三年每个专业的分数线是多少	__label__河北专业分数线
有河北省每个专业具体的分数线吗	__label__河北专业分数线
能知道河北省三年来每个专业的最低录取分数吗	__label__河北专业分数线
河北专业详细分数线多少	__label__河北专业分数线
有河北三年的分数线吗，最好知道每个专业的录取分	__label__河北专业分数线
有河北本省的分数线吗，具体到各专业的那种	__label__河北专业分数线
请问去年河北各专业的录取分大概多少，谁高谁低啊	__label__河北专业分数线
请问去年河北各专业的录取分大概多少，哪些专业比较高啊	__label__河北专业分数线
能提供一下河北这三年的分数线吗	__label__河北专业分数线
我想了解河北的分数线	__label__河北专业分数线
2018年河北各专业录取分数线	__label__河北专业分数线
有河北16,17,18年的分数线吗分专业的	__label__河北专业分数线
河北的分数线怎么样，各专业录取分数大概多少	__label__河北专业分数线
黑龙江专业分数线	__label__黑龙江专业分数线
黑龙江的录取线	__label__黑龙江专业分数线
黑龙江这三年每个专业的分数线是多少	__label__黑龙江专业分数线
有黑龙江省每个专业具体的分数线吗	__label__黑龙江专业分数线
能知道黑龙江省三年来每个专业的最低录取分数吗	__label__黑龙江专业分数线
黑龙江专业详细分数线多少	__label__黑龙江专业分数线
有黑龙江三年的分数线吗，最好知道每个专业的录取分	__label__黑龙江专业分数线
有黑龙江本省的分数线吗，具体到各专业的那种	__label__黑龙江专业分数线
请问去年黑龙江各专业的录取分大概多少，谁高谁低啊	__label__黑龙江专业分数线
请问去年黑龙江各专业的录取分大概多少，哪些专业比较高啊	__label__黑龙江专业分数线
能提供一下黑龙江这三年的分数线吗	__label__黑龙江专业分数线
我想了解黑龙江的分数线	__label__黑龙江专业分数线
2018年黑龙江各专业录取分数线	__label__黑龙江专业分数线
有黑龙江16,17,18年的分数线吗分专业的	__label__黑龙江专业分数线
黑龙江的分数线怎么样，各专业录取分数大概多少	__label__黑龙江专业分数线
湖北专业分数线	__label__湖北专业分数线
湖北的录取线	__label__湖北专业分数线
湖北这三年每个专业的分数线是多少	__label__湖北专业分数线
有湖北省每个专业具体的分数线吗	__label__湖北专业分数线
能知道湖北省三年来每个专业的最低录取分数吗	__label__湖北专业分数线
湖北专业详细分数线多少	__label__湖北专业分数线
有湖北三年的分数线吗，最好知道每个专业的录取分	__label__湖北专业分数线
有湖北本省的分数线吗，具体到各专业的那种	__label__湖北专业分数线
请问去年湖北各专业的录取分大概多少，谁高谁低啊	__label__湖北专业分数线
请问去年湖北各专业的录取分大概多少，哪些专业比较高啊	__label__湖北专业分数线
能提供一下湖北这三年的分数线吗	__label__湖北专业分数线
我想了解湖北的分数线	__label__湖北专业分数线
2018年湖北各专业录取分数线	__label__湖北专业分数线
有湖北16,17,18年的分数线吗分专业的	__label__湖北专业分数线
湖北的分数线怎么样，各专业录取分数大概多少	__label__湖北专业分数线
湖南专业分数线	__label__湖南专业分数线
湖南的录取线	__label__湖南专业分数线
湖南这三年每个专业的分数线是多少	__label__湖南专业分数线
有湖南省每个专业具体的分数线吗	__label__湖南专业分数线
能知道湖南省三年来每个专业的最低录取分数吗	__label__湖南专业分数线
湖南专业详细分数线多少	__label__湖南专业分数线
有湖南三年的分数线吗，最好知道每个专业的录取分	__label__湖南专业分数线
有湖南本省的分数线吗，具体到各专业的那种	__label__湖南专业分数线
请问去年湖南各专业的录取分大概多少，谁高谁低啊	__label__湖南专业分数线
请问去年湖南各专业的录取分大概多少，哪些专业比较高啊	__label__湖南专业分数线
能提供一下湖南这三年的分数线吗	__label__湖南专业分数线
我想了解湖南的分数线	__label__湖南专业分数线
2018年湖南各专业录取分数线	__label__湖南专业分数线
有湖南16,17,18年的分数线吗分专业的	__label__湖南专业分数线
湖南的分数线怎么样，各专业录取分数大概多少	__label__湖南专业分数线
吉林专业分数线	__label__吉林专业分数线
吉林的录取线	__label__吉林专业分数线
吉林这三年每个专业的分数线是多少	__label__吉林专业分数线
有吉林省每个专业具体的分数线吗	__label__吉林专业分数线
能知道吉林省三年来每个专业的最低录取分数吗	__label__吉林专业分数线
吉林专业详细分数线多少	__label__吉林专业分数线
有吉林三年的分数线吗，最好知道每个专业的录取分	__label__吉林专业分数线
有吉林本省的分数线吗，具体到各专业的那种	__label__吉林专业分数线
请问去年吉林各专业的录取分大概多少，谁高谁低啊	__label__吉林专业分数线
请问去年吉林各专业的录取分大概多少，哪些专业比较高啊	__label__吉林专业分数线
能提供一下吉林这三年的分数线吗	__label__吉林专业分数线
我想了解吉林的分数线	__label__吉林专业分数线
2018年吉林各专业录取分数线	__label__吉林专业分数线
有吉林16,17,18年的分数线吗分专业的	__label__吉林专业分数线
吉林的分数线怎么样，各专业录取分数大概多少	__label__吉林专业分数线
江苏专业分数线	__label__江苏专业分数线 
江苏的录取线	__label__江苏专业分数线 
江苏这三年每个专业的分数线是多少	__label__江苏专业分数线 
有江苏省每个专业具体的分数线吗	__label__江苏专业分数线 
能知道江苏省三年来每个专业的最低录取分数吗	__label__江苏专业分数线 
江苏专业详细分数线多少	__label__江苏专业分数线 
有江苏三年的分数线吗，最好知道每个专业的录取分	__label__江苏专业分数线 
有江苏本省的分数线吗，具体到各专业的那种	__label__江苏专业分数线 
请问去年江苏各专业的录取分大概多少，谁高谁低啊	__label__江苏专业分数线 
请问去年江苏各专业的录取分大概多少，哪些专业比较高啊	__label__江苏专业分数线 
能提供一下江苏这三年的分数线吗	__label__江苏专业分数线 
我想了解江苏的分数线	__label__江苏专业分数线 
2018年江苏各专业录取分数线	__label__江苏专业分数线 
有江苏16,17,18年的分数线吗分专业的	__label__江苏专业分数线 
江苏的分数线怎么样，各专业录取分数大概多少	__label__江苏专业分数线 
江西专业分数线	__label__江西专业分数线
江西录取线	__label__江西专业分数线
江西这三年每个专业的分数线是多少	__label__江西专业分数线
有江西省每个专业具体的分数线吗	__label__江西专业分数线
能知道江西省三年来每个专业的最低录取分数吗	__label__江西专业分数线
江西专业详细分数线多少	__label__江西专业分数线
有江西三年的分数线吗，最好知道每个专业的录取分	__label__江西专业分数线
有江西本省的分数线吗，具体到各专业的那种	__label__江西专业分数线
请问去年江西各专业的录取分大概多少，谁高谁低啊	__label__江西专业分数线
请问去年江西各专业的录取分大概多少，哪些专业比较高啊	__label__江西专业分数线
能提供一下江西这三年的分数线吗	__label__江西专业分数线
我想了解江西的分数线	__label__江西专业分数线
2018年江西各专业录取分数线	__label__江西专业分数线
有江西16,17,18年的分数线吗分专业的	__label__江西专业分数线
江西的分数线怎么样，各专业录取分数大概多少	__label__江西专业分数线
辽宁专业分数线	__label__辽宁专业分数线
辽宁的录取线	__label__辽宁专业分数线
辽宁这三年每个专业的分数线是多少	__label__辽宁专业分数线
有辽宁省每个专业具体的分数线吗	__label__辽宁专业分数线
能知道辽宁省三年来每个专业的最低录取分数吗	__label__辽宁专业分数线
辽宁专业详细分数线多少	__label__辽宁专业分数线
有辽宁三年的分数线吗，最好知道每个专业的录取分	__label__辽宁专业分数线
有辽宁本省的分数线吗，具体到各专业的那种	__label__辽宁专业分数线
请问去年辽宁各专业的录取分大概多少，谁高谁低啊	__label__辽宁专业分数线
请问去年辽宁各专业的录取分大概多少，哪些专业比较高啊	__label__辽宁专业分数线
能提供一下辽宁这三年的分数线吗	__label__辽宁专业分数线
我想了解辽宁的分数线	__label__辽宁专业分数线
2018年辽宁各专业录取分数线	__label__辽宁专业分数线
有辽宁16,17,18年的分数线吗分专业的	__label__辽宁专业分数线
辽宁的分数线怎么样，各专业录取分数大概多少	__label__辽宁专业分数线
四川专业分数线	__label__四川专业分数线
四川的录取线	__label__四川专业分数线
四川这三年每个专业的分数线是多少	__label__四川专业分数线
有四川省每个专业具体的分数线吗	__label__四川专业分数线
能知道四川省三年来每个专业的最低录取分数吗	__label__四川专业分数线
四川专业详细分数线多少	__label__四川专业分数线
有四川三年的分数线吗，最好知道每个专业的录取分	__label__四川专业分数线
有四川本省的分数线吗，具体到各专业的那种	__label__四川专业分数线
请问去年四川各专业的录取分大概多少，谁高谁低啊	__label__四川专业分数线
请问去年四川各专业的录取分大概多少，哪些专业比较高啊	__label__四川专业分数线
能提供一下四川这三年的分数线吗	__label__四川专业分数线
我想了解四川的分数线	__label__四川专业分数线
2018年四川各专业录取分数线	__label__四川专业分数线
有四川16,17,18年的分数线吗分专业的	__label__四川专业分数线
四川的分数线怎么样，各专业录取分数大概多少	__label__四川专业分数线
浙江专业分数线	__label__浙江专业分数线
浙江的录取线	__label__浙江专业分数线
浙江这三年每个专业的分数线是多少	__label__浙江专业分数线
有浙江省每个专业具体的分数线吗	__label__浙江专业分数线
能知道浙江省三年来每个专业的最低录取分数吗	__label__浙江专业分数线
浙江专业详细分数线多少	__label__浙江专业分数线
有浙江三年的分数线吗，最好知道每个专业的录取分	__label__浙江专业分数线
有浙江本省的分数线吗，具体到各专业的那种	__label__浙江专业分数线
请问去年浙江各专业的录取分大概多少，谁高谁低啊	__label__浙江专业分数线
请问去年浙江各专业的录取分大概多少，哪些专业比较高啊	__label__浙江专业分数线
能提供一下浙江这三年的分数线吗	__label__浙江专业分数线
我想了解浙江的分数线	__label__浙江专业分数线
2018年浙江各专业录取分数线	__label__浙江专业分数线
有浙江16,17,18年的分数线吗分专业的	__label__浙江专业分数线
浙江的分数线怎么样，各专业录取分数大概多少	__label__浙江专业分数线
云南专业分数线	__label__云南专业分数线
云南的录取线	__label__云南专业分数线
云南这三年每个专业的分数线是多少	__label__云南专业分数线
有云南省每个专业具体的分数线吗	__label__云南专业分数线
能知道云南省三年来每个专业的最低录取分数吗	__label__云南专业分数线
云南专业详细分数线多少	__label__云南专业分数线
有云南三年的分数线吗，最好知道每个专业的录取分	__label__云南专业分数线
有云南本省的分数线吗，具体到各专业的那种	__label__云南专业分数线
请问去年云南各专业的录取分大概多少，谁高谁低啊	__label__云南专业分数线
请问去年云南各专业的录取分大概多少，哪些专业比较高啊	__label__云南专业分数线
能提供一下云南这三年的分数线吗	__label__云南专业分数线
我想了解云南的分数线	__label__云南专业分数线
2018年云南各专业录取分数线	__label__云南专业分数线
有云南16,17,18年的分数线吗分专业的	__label__云南专业分数线
云南的分数线怎么样，各专业录取分数大概多少	__label__云南专业分数线
重庆专业分数线	__label__重庆专业分数线
重庆的录取线	__label__重庆专业分数线
重庆这三年每个专业的分数线是多少	__label__重庆专业分数线
有重庆省每个专业具体的分数线吗	__label__重庆专业分数线
能知道重庆省三年来每个专业的最低录取分数吗	__label__重庆专业分数线
重庆专业详细分数线多少	__label__重庆专业分数线
有重庆三年的分数线吗，最好知道每个专业的录取分	__label__重庆专业分数线
有重庆本省的分数线吗，具体到各专业的那种	__label__重庆专业分数线
请问去年重庆各专业的录取分大概多少，谁高谁低啊	__label__重庆专业分数线
请问去年重庆各专业的录取分大概多少，哪些专业比较高啊	__label__重庆专业分数线
能提供一下重庆这三年的分数线吗	__label__重庆专业分数线
我想了解重庆的分数线	__label__重庆专业分数线
2018年重庆各专业录取分数线	__label__重庆专业分数线
有重庆16,17,18年的分数线吗分专业的	__label__重庆专业分数线
重庆的分数线怎么样，各专业录取分数大概多少	__label__重庆专业分数线
官网网址	__label__官网网址
学校官网是什么	__label__官网网址
有学校官方网站吗	__label__官网网址
有校园网站链接吗	__label__官网网址
有深圳校区单独的网站吗	__label__官网网址
校园官网网址多少	__label__官网网址
学校官网多少	__label__官网网址
给个官网链接呗	__label__官网网址
招生网网址	__label__招生网网址
有本科招生网站吗	__label__招生网网址
招生网站网址多少	__label__招生网网址
能给一个招生网站的链接吗	__label__招生网网址
有招生官网吗	__label__招生网网址
招生官网是跟本部一个界面吗	__label__招生网网址
有深圳校区单独的招生官网吗	__label__招生网网址
给一个招生网站的链接呗	__label__招生网网址
招生公众号	__label__招生公众号
本科招生办微信公众号是多少	__label__招生公众号
有招生办公众号吗	__label__招生公众号
招生这一块有微信平台吗	__label__招生公众号
有招生公众平台发一个吗	__label__招生公众号
有什么解答问题的公众号之类的吗	__label__招生公众号
报考专业	__label__报考专业
今年都有什么招生专业啊	__label__报考专业
哪些专业开放招生	__label__报考专业
招生的专业还和去年一样吗	__label__报考专业
今年招生专业变多了吗	__label__报考专业
可以报考的专业还是那些吗	__label__报考专业
招生专业是什么	__label__报考专业
招生组行程	__label__招生组行程
招生组什么行程	__label__招生组行程
接下来招生组会去哪里啊	__label__招生组行程
之后招生组去哪宣讲	__label__招生组行程
有各省招生组的动向吗	__label__招生组行程
招生老师会去学校宣讲吗	__label__招生组行程
各省招生老师联系方式	__label__各省招生老师联系方式
有负责每个省的招生老师的电话吗	__label__各省招生老师联系方式
有负责每个省的招生老师的联系方式吗	__label__各省招生老师联系方式
有分省的联系方式吗	__label__各省招生老师联系方式
负责辽宁的老师电话多少	__label__各省招生老师联系方式
我能联系一下辽宁的老师吗	__label__各省招生老师联系方式
能提供一下辽宁省老师的联系方式吗	__label__各省招生老师联系方式
我想找辽宁招生老师	__label__各省招生老师联系方式
我有问题想问招生老师，有辽宁的老师吗	__label__各省招生老师联系方式
那辽宁的老师的电话呢	__label__各省招生老师联系方式
负责河北的老师电话多少	__label__各省招生老师联系方式
我能联系一下河北的老师吗	__label__各省招生老师联系方式
能提供一下河北省老师的联系方式吗	__label__各省招生老师联系方式
我想找河北招生老师	__label__各省招生老师联系方式
我有问题想问招生老师，有河北的老师吗	__label__各省招生老师联系方式
那河北的老师的电话呢	__label__各省招生老师联系方式
负责黑龙江的老师电话多少	__label__各省招生老师联系方式
我能联系一下黑龙江的老师吗	__label__各省招生老师联系方式
能提供一下黑龙江省老师的联系方式吗	__label__各省招生老师联系方式
我想找黑龙江招生老师	__label__各省招生老师联系方式
我有问题想问招生老师，有黑龙江的老师吗	__label__各省招生老师联系方式
那黑龙江的老师的电话呢	__label__各省招生老师联系方式
负责吉林的老师电话多少	__label__各省招生老师联系方式
我能联系一下吉林的老师吗	__label__各省招生老师联系方式
能提供一下吉林省老师的联系方式吗	__label__各省招生老师联系方式
我想找吉林招生老师	__label__各省招生老师联系方式
我有问题想问招生老师，有吉林的老师吗	__label__各省招生老师联系方式
那吉林的老师的电话呢	__label__各省招生老师联系方式
负责江苏的老师电话多少	__label__各省招生老师联系方式
我能联系一下江苏的老师吗	__label__各省招生老师联系方式
能提供一下江苏省老师的联系方式吗	__label__各省招生老师联系方式
我想找江苏招生老师	__label__各省招生老师联系方式
我有问题想问招生老师，有江苏的老师吗	__label__各省招生老师联系方式
那江苏的老师的电话呢	__label__各省招生老师联系方式
负责浙江的老师电话多少	__label__各省招生老师联系方式
我能联系一下浙江的老师吗	__label__各省招生老师联系方式
能提供一下浙江省老师的联系方式吗	__label__各省招生老师联系方式
我想找浙江招生老师	__label__各省招生老师联系方式
我有问题想问招生老师，有浙江的老师吗	__label__各省招生老师联系方式
那浙江的老师的电话呢	__label__各省招生老师联系方式
负责贵州的老师电话多少	__label__各省招生老师联系方式
我能联系一下贵州的老师吗	__label__各省招生老师联系方式
能提供一下贵州省老师的联系方式吗	__label__各省招生老师联系方式
我想找贵州招生老师	__label__各省招生老师联系方式
我有问题想问招生老师，有贵州的老师吗	__label__各省招生老师联系方式
那贵州的老师的电话呢	__label__各省招生老师联系方式
负责云南的老师电话多少	__label__各省招生老师联系方式
我能联系一下云南的老师吗	__label__各省招生老师联系方式
能提供一下云南省老师的联系方式吗	__label__各省招生老师联系方式
我想找云南招生老师	__label__各省招生老师联系方式
我有问题想问招生老师，有云南的老师吗	__label__各省招生老师联系方式
那云南的老师的电话呢	__label__各省招生老师联系方式
负责安徽的老师电话多少	__label__各省招生老师联系方式
我能联系一下安徽的老师吗	__label__各省招生老师联系方式
能提供一下安徽省老师的联系方式吗	__label__各省招生老师联系方式
我想找安徽招生老师	__label__各省招生老师联系方式
我有问题想问招生老师，有安徽的老师吗	__label__各省招生老师联系方式
那安徽的老师的电话呢	__label__各省招生老师联系方式
负责福建的老师电话多少	__label__各省招生老师联系方式
我能联系一下福建的老师吗	__label__各省招生老师联系方式
能提供一下福建省老师的联系方式吗	__label__各省招生老师联系方式
我想找福建招生老师	__label__各省招生老师联系方式
我有问题想问招生老师，有福建的老师吗	__label__各省招生老师联系方式
那福建的老师的电话呢	__label__各省招生老师联系方式
负责江西的老师电话多少	__label__各省招生老师联系方式
我能联系一下江西的老师吗	__label__各省招生老师联系方式
能提供一下江西省老师的联系方式吗	__label__各省招生老师联系方式
我想找江西招生老师	__label__各省招生老师联系方式
我有问题想问招生老师，有江西的老师吗	__label__各省招生老师联系方式
那江西的老师的电话呢	__label__各省招生老师联系方式
负责广东的老师电话多少	__label__各省招生老师联系方式
我能联系一下广东的老师吗	__label__各省招生老师联系方式
能提供一下广东省老师的联系方式吗	__label__各省招生老师联系方式
我想找广东招生老师	__label__各省招生老师联系方式
我有问题想问招生老师，有广东的老师吗	__label__各省招生老师联系方式
那广东的老师的电话呢	__label__各省招生老师联系方式
负责四川的老师电话多少	__label__各省招生老师联系方式
我能联系一下四川的老师吗	__label__各省招生老师联系方式
能提供一下四川省老师的联系方式吗	__label__各省招生老师联系方式
我想找四川招生老师	__label__各省招生老师联系方式
我有问题想问招生老师，有四川的老师吗	__label__各省招生老师联系方式
那四川的老师的电话呢	__label__各省招生老师联系方式
负责河南的老师电话多少	__label__各省招生老师联系方式
我能联系一下河南的老师吗	__label__各省招生老师联系方式
能提供一下河南省老师的联系方式吗	__label__各省招生老师联系方式
我想找河南招生老师	__label__各省招生老师联系方式
我有问题想问招生老师，有河南的老师吗	__label__各省招生老师联系方式
那河南的老师的电话呢	__label__各省招生老师联系方式
负责广西的老师电话多少	__label__各省招生老师联系方式
我能联系一下广西的老师吗	__label__各省招生老师联系方式
能提供一下广西省老师的联系方式吗	__label__各省招生老师联系方式
我想找广西招生老师	__label__各省招生老师联系方式
我有问题想问招生老师，有广西的老师吗	__label__各省招生老师联系方式
那广西的老师的电话呢	__label__各省招生老师联系方式
负责海南的老师电话多少	__label__各省招生老师联系方式
我能联系一下海南的老师吗	__label__各省招生老师联系方式
能提供一下海南省老师的联系方式吗	__label__各省招生老师联系方式
我想找海南招生老师	__label__各省招生老师联系方式
我有问题想问招生老师，有海南的老师吗	__label__各省招生老师联系方式
那海南的老师的电话呢	__label__各省招生老师联系方式
负责重庆的老师电话多少	__label__各省招生老师联系方式
我能联系一下重庆的老师吗	__label__各省招生老师联系方式
能提供一下重庆省老师的联系方式吗	__label__各省招生老师联系方式
我想找重庆招生老师	__label__各省招生老师联系方式
我有问题想问招生老师，有重庆的老师吗	__label__各省招生老师联系方式
那重庆的老师的电话呢	__label__各省招生老师联系方式
负责湖南的老师电话多少	__label__各省招生老师联系方式
我能联系一下湖南的老师吗	__label__各省招生老师联系方式
能提供一下湖南省老师的联系方式吗	__label__各省招生老师联系方式
我想找湖南招生老师	__label__各省招生老师联系方式
我有问题想问招生老师，有湖南的老师吗	__label__各省招生老师联系方式
那湖南的老师的电话呢	__label__各省招生老师联系方式
负责湖北的老师电话多少	__label__各省招生老师联系方式
我能联系一下湖北的老师吗	__label__各省招生老师联系方式
能提供一下湖北省老师的联系方式吗	__label__各省招生老师联系方式
我想找湖北招生老师	__label__各省招生老师联系方式
我有问题想问招生老师，有湖北的老师吗	__label__各省招生老师联系方式
那湖北的老师的电话呢	__label__各省招生老师联系方式
负责宁夏的老师电话多少	__label__各省招生老师联系方式
我能联系一下宁夏的老师吗	__label__各省招生老师联系方式
能提供一下宁夏省老师的联系方式吗	__label__各省招生老师联系方式
我想找宁夏招生老师	__label__各省招生老师联系方式
我有问题想问招生老师，有宁夏的老师吗	__label__各省招生老师联系方式
那宁夏的老师的电话呢	__label__各省招生老师联系方式
有没有辽宁的QQ群	__label__各省招生老师联系方式
那辽宁的QQ群号是多少	__label__各省招生老师联系方式
辽宁QQ群号	__label__各省招生老师联系方式
有没有辽宁的群	__label__各省招生老师联系方式
有没有河北的QQ群	__label__各省招生老师联系方式
那河北的QQ群号是多少	__label__各省招生老师联系方式
河北QQ群号	__label__各省招生老师联系方式
有没有河北的群	__label__各省招生老师联系方式
有没有吉林的QQ群	__label__各省招生老师联系方式
那吉林的QQ群号是多少	__label__各省招生老师联系方式
吉林QQ群号	__label__各省招生老师联系方式
有没有吉林的群	__label__各省招生老师联系方式
有没有黑龙江的QQ群	__label__各省招生老师联系方式
那黑龙江的QQ群号是多少	__label__各省招生老师联系方式
黑龙江QQ群号	__label__各省招生老师联系方式
有没有黑龙江的群	__label__各省招生老师联系方式
有没有江苏的QQ群	__label__各省招生老师联系方式
那江苏的QQ群号是多少	__label__各省招生老师联系方式
江苏QQ群号	__label__各省招生老师联系方式
有没有江苏的群	__label__各省招生老师联系方式
有没有浙江的QQ群	__label__各省招生老师联系方式
那浙江的QQ群号是多少	__label__各省招生老师联系方式
浙江QQ群号	__label__各省招生老师联系方式
有没有浙江的群	__label__各省招生老师联系方式
有没有贵州的QQ群	__label__各省招生老师联系方式
那贵州的QQ群号是多少	__label__各省招生老师联系方式
贵州QQ群号	__label__各省招生老师联系方式
有没有贵州的群	__label__各省招生老师联系方式
有没有云南的QQ群	__label__各省招生老师联系方式
那云南的QQ群号是多少	__label__各省招生老师联系方式
云南QQ群号	__label__各省招生老师联系方式
有没有云南的群	__label__各省招生老师联系方式
有没有安徽的QQ群	__label__各省招生老师联系方式
那安徽的QQ群号是多少	__label__各省招生老师联系方式
安徽QQ群号	__label__各省招生老师联系方式
有没有安徽的群	__label__各省招生老师联系方式
有没有福建的QQ群	__label__各省招生老师联系方式
那福建的QQ群号是多少	__label__各省招生老师联系方式
福建QQ群号	__label__各省招生老师联系方式
有没有福建的群	__label__各省招生老师联系方式
有没有江西的QQ群	__label__各省招生老师联系方式
那江西的QQ群号是多少	__label__各省招生老师联系方式
江西QQ群号	__label__各省招生老师联系方式
有没有江西的群	__label__各省招生老师联系方式
有没有广东的QQ群	__label__各省招生老师联系方式
那广东的QQ群号是多少	__label__各省招生老师联系方式
广东QQ群号	__label__各省招生老师联系方式
有没有广东的群	__label__各省招生老师联系方式
有没有四川的QQ群	__label__各省招生老师联系方式
那四川的QQ群号是多少	__label__各省招生老师联系方式
四川QQ群号	__label__各省招生老师联系方式
有没有四川的群	__label__各省招生老师联系方式
有没有河南的QQ群	__label__各省招生老师联系方式
那河南的QQ群号是多少	__label__各省招生老师联系方式
河南QQ群号	__label__各省招生老师联系方式
有没有河南的群	__label__各省招生老师联系方式
有没有广西的QQ群	__label__各省招生老师联系方式
那广西的QQ群号是多少	__label__各省招生老师联系方式
广西QQ群号	__label__各省招生老师联系方式
有没有广西的群	__label__各省招生老师联系方式
有没有海南的QQ群	__label__各省招生老师联系方式
那海南的QQ群号是多少	__label__各省招生老师联系方式
海南QQ群号	__label__各省招生老师联系方式
有没有海南的群	__label__各省招生老师联系方式
有没有重庆的QQ群	__label__各省招生老师联系方式
那重庆的QQ群号是多少	__label__各省招生老师联系方式
重庆QQ群号	__label__各省招生老师联系方式
有没有重庆的群	__label__各省招生老师联系方式
有没有湖北的QQ群	__label__各省招生老师联系方式
那湖北的QQ群号是多少	__label__各省招生老师联系方式
湖北QQ群号	__label__各省招生老师联系方式
有没有湖北的群	__label__各省招生老师联系方式
有没有湖南的QQ群	__label__各省招生老师联系方式
那湖南的QQ群号是多少	__label__各省招生老师联系方式
湖南QQ群号	__label__各省招生老师联系方式
有没有湖南的群	__label__各省招生老师联系方式
有没有宁夏的QQ群	__label__各省招生老师联系方式
那宁夏的QQ群号是多少	__label__各省招生老师联系方式
宁夏QQ群号	__label__各省招生老师联系方式
有没有宁夏的群	__label__各省招生老师联系方式
有分省的QQ群吗	__label__各省招生老师联系方式
学校公众号	__label__学校公众号
本科招生办微信公众号是多少	__label__学校公众号
有招生办公众号吗	__label__学校公众号
招生这一块有微信平台吗	__label__学校公众号
有招生公众平台发一个吗	__label__学校公众号
有什么公众号之类的吗	__label__学校公众号
军训	__label__军训
大一军训是什么时候	__label__军训
军训在学校里吗	__label__军训
军训是校内军训还是校外啊	__label__军训
军训辛不辛苦	__label__军训
本科生人数	__label__本科生人数
哈工大深圳每年招多少本科生	__label__本科生人数
现在有多少本科生了	__label__本科生人数
教师队伍	__label__教师队伍
你们学校老师帅吗	__label__教师队伍
哈工大深圳的师资如何	__label__教师队伍
哈深的院士有哪些	__label__教师队伍
哈工大老师怎么样	__label__教师队伍
哈工大深圳有多少院士	__label__教师队伍
校园面积	__label__校园面积
学校占地多少亩	__label__校园面积
学校大不大啊	__label__校园面积
听说深圳校区比本部小	__label__校园面积
深圳校区和本部比谁大啊	__label__校园面积
选择哈深理由	__label__选择哈深理由
哈工大深圳好不好	__label__选择哈深理由
这个校区怎么样啊	__label__选择哈深理由
校领导	__label__校领导
哈深校长是谁	__label__校领导
哈深党委书记是谁	__label__校领导
哈深副校长是谁	__label__校领导
哈深常务副校长是谁	__label__校领导
哈深校领导都有谁啊	__label__校领导
哈深校长和本部是一个吗	__label__校领导
自主招生	__label__自主招生
深圳校区为什么没有自主招生	__label__自主招生
有自招政策吗	__label__自主招生
有没有什么自主招生项目啊	__label__自主招生
有自招名额吗	__label__自主招生
专业省排	__label__专业省排
专业收分多少	__label__专业省排
有专业省排名吗	__label__专业省排
四川专业收分多少	__label__专业省排
有四川省专业省排名吗	__label__专业省排
四川收分情况	__label__专业省排
河北专业收分多少	__label__专业省排
有河北省专业省排名吗	__label__专业省排
河北收分情况	__label__专业省排
吉林专业收分多少	__label__专业省排
有吉林省专业省排名吗	__label__专业省排
吉林收分情况	__label__专业省排
黑龙江专业收分多少	__label__专业省排
有黑龙江省专业省排名吗	__label__专业省排
黑龙江收分情况	__label__专业省排
江苏专业收分多少	__label__专业省排
有江苏省专业省排名吗	__label__专业省排
江苏收分情况	__label__专业省排
辽宁专业收分多少	__label__专业省排
有辽宁省专业省排名吗	__label__专业省排
辽宁收分情况	__label__专业省排
浙江专业收分多少	__label__专业省排
有浙江省专业省排名吗	__label__专业省排
浙江收分情况	__label__专业省排
贵州专业收分多少	__label__专业省排
有贵州省专业省排名吗	__label__专业省排
贵州收分情况	__label__专业省排
云南专业收分多少	__label__专业省排
有云南省专业省排名吗	__label__专业省排
云南收分情况	__label__专业省排
安徽专业收分多少	__label__专业省排
有安徽省专业省排名吗	__label__专业省排
安徽收分情况	__label__专业省排
福建专业收分多少	__label__专业省排
有福建省专业省排名吗	__label__专业省排
福建收分情况	__label__专业省排
江西专业收分多少	__label__专业省排
有江西省专业省排名吗	__label__专业省排
江西收分情况	__label__专业省排
广东专业收分多少	__label__专业省排
有广东省专业省排名吗	__label__专业省排
广东收分情况	__label__专业省排
河南专业收分多少	__label__专业省排
有河南省专业省排名吗	__label__专业省排
河南收分情况	__label__专业省排
广西专业收分多少	__label__专业省排
有广西省专业省排名吗	__label__专业省排
广西收分情况	__label__专业省排
海南专业收分多少	__label__专业省排
有海南省专业省排名吗	__label__专业省排
海南收分情况	__label__专业省排
重庆专业收分多少	__label__专业省排
有重庆省专业省排名吗	__label__专业省排
重庆收分情况	__label__专业省排
湖北专业收分多少	__label__专业省排
有湖北省专业省排名吗	__label__专业省排
湖北收分情况	__label__专业省排
湖南专业收分多少	__label__专业省排
有湖南省专业省排名吗	__label__专业省排
湖南收分情况	__label__专业省排
宁夏专业收分多少	__label__专业省排
有宁夏省专业省排名吗	__label__专业省排
宁夏收分情况	__label__专业省排
大概多少名能上计算机专业	__label__专业省排
大概多少名能上机械专业	__label__专业省排
大概多少名能上材料专业	__label__专业省排
大概多少名能上电信专业	__label__专业省排
大概多少名能上土木专业	__label__专业省排
大概多少名能上经济专业	__label__专业省排
大概多少名能上自动化专业	__label__专业省排
大概多少名能上环境专业	__label__专业省排
大概多少名能上电气专业	__label__专业省排
本部交流	__label__本部交流
请问哈工大本部和深圳校区可以互相交流学习吗	__label__本部交流
我问的是哈尔滨工大本部的学生可以到深圳来学习吗	__label__本部交流
我问的是哈尔滨工大深圳的学生可以去本部学习吗	__label__本部交流
三个校区直接有交流交换吗	__label__本部交流
专业课	__label__专业课
计算机学什么课程	__label__专业课
计算机都有什么专业课啊	__label__专业课
计算机大概都学什么啊	__label__专业课
计算机专业主干课程	__label__专业课
机械学什么课程	__label__专业课
机械都有什么专业课啊	__label__专业课
机械大概都学什么啊	__label__专业课
机械专业主干课程	__label__专业课
材料学什么课程	__label__专业课
材料都有什么专业课啊	__label__专业课
材料大概都学什么啊	__label__专业课
材料专业主干课程	__label__专业课
电信学什么课程	__label__专业课
电信都有什么专业课啊	__label__专业课
电信大概都学什么啊	__label__专业课
电信专业主干课程	__label__专业课
土木学什么课程	__label__专业课
土木都有什么专业课啊	__label__专业课
土木大概都学什么啊	__label__专业课
土木专业主干课程	__label__专业课
经济学什么课程	__label__专业课
经济都有什么专业课啊	__label__专业课
经济大概都学什么啊	__label__专业课
经济专业主干课程	__label__专业课
自动化学什么课程	__label__专业课
自动化都有什么专业课啊	__label__专业课
自动化大概都学什么啊	__label__专业课
自动化专业主干课程	__label__专业课
环境学什么课程	__label__专业课
环境都有什么专业课啊	__label__专业课
环境大概都学什么啊	__label__专业课
环境专业主干课程	__label__专业课
电气学什么课程	__label__专业课
电气都有什么专业课啊	__label__专业课
电气大概都学什么啊	__label__专业课
电气专业主干课程	__label__专业课
建筑学什么课程	__label__专业课
建筑都有什么专业课啊	__label__专业课
建筑大概都学什么啊	__label__专业课
建筑专业主干课程	__label__专业课
数学学什么课程	__label__专业课
数学都有什么专业课啊	__label__专业课
数学大概都学什么啊	__label__专业课
数学专业主干课程	__label__专业课
工商管理学什么课程	__label__专业课
工商管理都有什么专业课啊	__label__专业课
工商管理大概都学什么啊	__label__专业课
工商管理专业主干课程	__label__专业课
有没有各专业的课程介绍啊	__label__专业课
招生简章	__label__招生简章
哈深的招生简章出了吗	__label__招生简章
有招生简章了吗	__label__招生简章
招生简章公布了没有	__label__招生简章
有2019的招生简章了吗	__label__招生简章
招生计划	__label__招生人数
今年招多少人	__label__招生人数
每个省招多少人啊	__label__招生人数
今年深圳计划招多少人	__label__招生人数
知道辽宁招多少人吗	__label__招生人数
辽宁计划招多少人	__label__招生人数
19年辽宁录取多少人	__label__招生人数
辽宁省的招生计划	__label__招生人数
知道河北招多少人吗	__label__招生人数
河北计划招多少人	__label__招生人数
19年河北录取多少人	__label__招生人数
河北省的招生计划	__label__招生人数
知道吉林招多少人吗	__label__招生人数
吉林计划招多少人	__label__招生人数
19年吉林录取多少人	__label__招生人数
吉林省的招生计划	__label__招生人数
知道黑龙江招多少人吗	__label__招生人数
黑龙江计划招多少人	__label__招生人数
19年黑龙江录取多少人	__label__招生人数
黑龙江省的招生计划	__label__招生人数
知道江苏招多少人吗	__label__招生人数
江苏计划招多少人	__label__招生人数
19年江苏录取多少人	__label__招生人数
江苏省的招生计划	__label__招生人数
知道浙江招多少人吗	__label__招生人数
浙江计划招多少人	__label__招生人数
19年浙江录取多少人	__label__招生人数
浙江省的招生计划	__label__招生人数
知道贵州招多少人吗	__label__招生人数
贵州计划招多少人	__label__招生人数
19年贵州录取多少人	__label__招生人数
贵州省的招生计划	__label__招生人数
知道云南招多少人吗	__label__招生人数
云南计划招多少人	__label__招生人数
19年云南录取多少人	__label__招生人数
云南省的招生计划	__label__招生人数
知道安徽招多少人吗	__label__招生人数
安徽计划招多少人	__label__招生人数
19年安徽录取多少人	__label__招生人数
安徽省的招生计划	__label__招生人数
知道福建招多少人吗	__label__招生人数
福建计划招多少人	__label__招生人数
19年福建录取多少人	__label__招生人数
福建省的招生计划	__label__招生人数
知道江西招多少人吗	__label__招生人数
江西计划招多少人	__label__招生人数
19年江西录取多少人	__label__招生人数
江西省的招生计划	__label__招生人数
知道广东招多少人吗	__label__招生人数
广东计划招多少人	__label__招生人数
19年广东录取多少人	__label__招生人数
广东省的招生计划	__label__招生人数
知道四川招多少人吗	__label__招生人数
四川计划招多少人	__label__招生人数
19年四川录取多少人	__label__招生人数
四川省的招生计划	__label__招生人数
知道河南招多少人吗	__label__招生人数
河南计划招多少人	__label__招生人数
19年河南录取多少人	__label__招生人数
河南省的招生计划	__label__招生人数
知道广西招多少人吗	__label__招生人数
广西计划招多少人	__label__招生人数
19年广西录取多少人	__label__招生人数
广西省的招生计划	__label__招生人数
知道海南招多少人吗	__label__招生人数
海南计划招多少人	__label__招生人数
19年海南录取多少人	__label__招生人数
海南省的招生计划	__label__招生人数
知道重庆招多少人吗	__label__招生人数
重庆计划招多少人	__label__招生人数
19年重庆录取多少人	__label__招生人数
重庆省的招生计划	__label__招生人数
知道湖北招多少人吗	__label__招生人数
湖北计划招多少人	__label__招生人数
19年湖北录取多少人	__label__招生人数
湖北省的招生计划	__label__招生人数
知道湖南招多少人吗	__label__招生人数
湖南计划招多少人	__label__招生人数
19年湖南录取多少人	__label__招生人数
湖南省的招生计划	__label__招生人数
知道宁夏招多少人吗	__label__招生人数
宁夏计划招多少人	__label__招生人数
19年宁夏录取多少人	__label__招生人数
宁夏省的招生计划	__label__招生人数
各专业基本情况	__label__各专业基本情况
自动化专业怎么样	__label__各专业基本情况
自动化专业好不好	__label__各专业基本情况
有自动化专业的介绍吗	__label__各专业基本情况
机械专业怎么样	__label__各专业基本情况
机械专业好不好	__label__各专业基本情况
有机械专业的介绍吗	__label__各专业基本情况
材料专业怎么样	__label__各专业基本情况
材料专业好不好	__label__各专业基本情况
有材料专业的介绍吗	__label__各专业基本情况
计算机专业怎么样	__label__各专业基本情况
计算机专业好不好	__label__各专业基本情况
有计算机专业的介绍吗	__label__各专业基本情况
电信专业怎么样	__label__各专业基本情况
电信专业好不好	__label__各专业基本情况
有电信专业的介绍吗	__label__各专业基本情况
土木专业怎么样	__label__各专业基本情况
土木专业好不好	__label__各专业基本情况
有土木专业的介绍吗	__label__各专业基本情况
经济专业怎么样	__label__各专业基本情况
经济专业好不好	__label__各专业基本情况
有经济专业的介绍吗	__label__各专业基本情况
环境专业怎么样	__label__各专业基本情况
环境专业好不好	__label__各专业基本情况
有环境专业的介绍吗	__label__各专业基本情况
电气专业怎么样	__label__各专业基本情况
电气专业好不好	__label__各专业基本情况
有电气专业的介绍吗	__label__各专业基本情况
建筑专业怎么样	__label__各专业基本情况
建筑专业好不好	__label__各专业基本情况
有建筑专业的介绍吗	__label__各专业基本情况
数学专业怎么样	__label__各专业基本情况
数学专业好不好	__label__各专业基本情况
有数学专业的介绍吗	__label__各专业基本情况
工商管理专业怎么样	__label__各专业基本情况
工商管理专业好不好	__label__各专业基本情况
有工商管理专业的介绍吗	__label__各专业基本情况
伙食费	__label__伙食费
伙食费一个月大概多少	__label__伙食费
一个月光吃饭要多少钱	__label__伙食费
生活费	__label__生活费
一个月得给孩子多少钱	__label__生活费
生活费大概多少	__label__生活费
生活费贵不贵啊	__label__生活费
学校地址邮编	__label__学校地址邮编
学校的地址在哪里	__label__学校地址邮编
学校的位置在哪里	__label__学校地址邮编
学校在哪个区啊	__label__学校地址邮编
学校邮编多少	__label__学校地址邮编
保专业政策	__label__保专业政策
保专业政策出了吗	__label__保专业政策
保专业政策出了吗	__label__保专业政策
有没有保专业的排名	__label__保专业政策
保专业政策是什么	__label__保专业政策
保专业力度大吗	__label__保专业政策
河北保专业政策	__label__保专业政策
河北多少名给保专业	__label__保专业政策
河北多少名保第一志愿	__label__保专业政策
河北多少名保前三专业	__label__保专业政策
吉林保专业政策	__label__保专业政策
吉林多少名给保专业	__label__保专业政策
吉林多少名保第一志愿	__label__保专业政策
吉林多少名保前三专业	__label__保专业政策
黑龙江保专业政策	__label__保专业政策
黑龙江多少名给保专业	__label__保专业政策
黑龙江多少名保第一志愿	__label__保专业政策
黑龙江多少名保前三专业	__label__保专业政策
江苏保专业政策	__label__保专业政策
江苏多少名给保专业	__label__保专业政策
江苏多少名保第一志愿	__label__保专业政策
江苏多少名保前三专业	__label__保专业政策
辽宁保专业政策	__label__保专业政策
辽宁多少名给保专业	__label__保专业政策
辽宁多少名保第一志愿	__label__保专业政策
辽宁多少名保前三专业	__label__保专业政策
浙江保专业政策	__label__保专业政策
浙江多少名给保专业	__label__保专业政策
浙江多少名保第一志愿	__label__保专业政策
浙江多少名保前三专业	__label__保专业政策
贵州保专业政策	__label__保专业政策
贵州多少名给保专业	__label__保专业政策
贵州多少名保第一志愿	__label__保专业政策
贵州多少名保前三专业	__label__保专业政策
云南保专业政策	__label__保专业政策
云南多少名给保专业	__label__保专业政策
云南多少名保第一志愿	__label__保专业政策
云南多少名保前三专业	__label__保专业政策
安徽保专业政策	__label__保专业政策
安徽多少名给保专业	__label__保专业政策
安徽多少名保第一志愿	__label__保专业政策
安徽多少名保前三专业	__label__保专业政策
福建保专业政策	__label__保专业政策
福建多少名给保专业	__label__保专业政策
福建多少名保第一志愿	__label__保专业政策
福建多少名保前三专业	__label__保专业政策
江西保专业政策	__label__保专业政策
江西多少名给保专业	__label__保专业政策
江西多少名保第一志愿	__label__保专业政策
江西多少名保前三专业	__label__保专业政策
四川保专业政策	__label__保专业政策
四川多少名给保专业	__label__保专业政策
四川多少名保第一志愿	__label__保专业政策
四川多少名保前三专业	__label__保专业政策
河南保专业政策	__label__保专业政策
河南多少名给保专业	__label__保专业政策
河南多少名保第一志愿	__label__保专业政策
河南多少名保前三专业	__label__保专业政策
广西保专业政策	__label__保专业政策
广西多少名给保专业	__label__保专业政策
广西多少名保第一志愿	__label__保专业政策
广西多少名保前三专业	__label__保专业政策
海南保专业政策	__label__保专业政策
海南多少名给保专业	__label__保专业政策
海南多少名保第一志愿	__label__保专业政策
海南多少名保前三专业	__label__保专业政策
重庆保专业政策	__label__保专业政策
重庆多少名给保专业	__label__保专业政策
重庆多少名保第一志愿	__label__保专业政策
重庆多少名保前三专业	__label__保专业政策
湖北保专业政策	__label__保专业政策
湖北多少名给保专业	__label__保专业政策
湖北多少名保第一志愿	__label__保专业政策
湖北多少名保前三专业	__label__保专业政策
湖南保专业政策	__label__保专业政策
湖南多少名给保专业	__label__保专业政策
湖南多少名保第一志愿	__label__保专业政策
湖南多少名保前三专业	__label__保专业政策
宁夏保专业政策	__label__保专业政策
宁夏多少名给保专业	__label__保专业政策
宁夏多少名保第一志愿	__label__保专业政策
宁夏多少名保前三专业	__label__保专业政策